**********************************************************
*.....................*..................................*
*.********.****.***..*.****************.****************.*
*.*...............*.*.*..................................*
*.*.********.****...*.*****************.****************.*
*.*.*...........*...*.*..................................*
*.*.*.*********.*.*.*.***************.******************.*
*.*.*.*...........*.*....................................*
*.*.*.*.*****.*.*.*.***************.********************.*
*.*.*.*.*...*...*.*......................................*
*.*.*.*.*.*.*.*.*.***************.************************
*.*.*.*.*...*.*.*........................................*
*.*.*.*.*****.*.***************.************.***********.*
*.*.*.*.......*..........................................*
*.*.*...*****......********.****************************.*
*.*.*.*..........*.......................................*
*.*.*.****..*.***.*******.*.***************************..*
*.*.*.*..................................................*
*...***.**********.*****.*********..**************....****
*...................*....................................*
**********************************************************
